
NO textures/wall.xpm
SO textures/ZZ.xpm
WE textures/abmoudni-_1_.xpm
EA textures/1.xpm

F 150,150,150
C 100,100,255

  11111
111001111111111111111
110000000000000000001
1000000000000W0000011
10000000000000000001
10000000011111111111
10000111111
100001
 111111
