
NO textures/wall.xpm
SO textures/wall.xpm
WE textures/wall.xpm
EA textures/wall.xpm

F 150,150,150
C 100,100,255

  11111
11100111111
10000000001
10000111111
1000N1
 111111
