NO            textures/wall.xpm
SO textures/wall.xpm
WE textures/eagle.xpm






F 220,100,0
EA textures/greystone.xpm
C     225  , 30,0

                                 111111111111111
                                 1D0000000000001
        111111111111111111111111111000000000001 
        1000000000110000000000001000000000000001
        1011000001110000000000001D100000000000001111111111111111
        100100000000000000000000DD1111111111110000000000011111
11111111101100000111000000000000111         11000000000001                
10000000001100000111d11111111111            1111100001111111    
1111011111111101110000001000111111111111111 110000000000001      
11110111111111011101010000000D0000000000001 11000000000001       
11000000110101011100000010000100000000000011000000000000001      
10000000000000001100000010001000000000000011D10000000000001      
100000000000000011010100100011000000000000DDD11111111111111      
11000001110101011111011110N0111111111111111111                
11110111 1110101 101111010001
11111111 1111111 111111111111