NO textures/wall.xpm
SO textures/wall.xpm
WE textures/eagle.xpm





F 220,100,0
EA textures/greystone.xpm
C 225,30,0
        1111111111111111111111111
        1000000000110000000000001
        1011000001110000000000001
        1001000000000000000000001
111111111011000001110000000000001
10000000001100000111011111111111
1111011111111101110000001000111111111111111
11110111111111011101010000000D0000000000001
1100000011010101110000001000d10000000000001
1000000000000000110000001000100000000000001
1000000000000000110101001000110000000000001
11000001110101011111011110N011111111111111111
11110111 1110101 101111010001
11111111 1111111 111111111111